#######################
#            #        #
# ### ########### ### #
# #                 # #
# # ############### # #
# # #               # #
# ### ########### ### #
# # #           # # # #
# # ### ####### # # # #
# # # # #     ### # ###
# # # # # ### # # # # #
# # # # ### #   # # # #
# # # # # # # # # #   #
# # # # #     # # # # #
# # # # ####### # # # #
# # # #         # # # #
# # # ############# # #
# # #             # # #
#   ######## ###### # #
###   #             # #
# ################### #
#                     #
#######################